		バランス	balance
		restraint	restraint
		勝負服	勝負服
		揉む	揉む
		グラブ	grub
		女装	women's clothing
		雑踏	congestion
		見られている	being watched
		衆人環視	public scrutiny
		注目を浴びる	get noticed
		ハンド逆	hand reverse
		ハンドギャグ	hand gag
		口ふさぎ	mouth covering
		置換	replacement
		締め付け	tightening
		父も見	my father also saw
		カメラ	camera
		陸上着	land arrival
		食いしばる	clench
		chart	chart
		押し倒す	push down
		片足	one leg
		ガニ	crab
		サンライズ	サンライズ
		制服	uniform
		uni	uni
		ハイライト	highlights
		振り向	turn around
		半開き	half-open
		素股	intercrural sex
		正面	front
		見開き	見開き
		仰向け	lying on your back
		あおむけ	lying on your back
		娼館	brothel
		散乱	scattering
		scatter	scatter
		hetelo	heteron
		san	san
		son	son
		白目	white of the eyes
		セリフ	dialogue
		吹き出し	speech bubble
		オノマトペ	onomatopoeia
		擬音	onomatopoeia
		rabit	rabbit
		ロデオ	rodeo
		venus	venus
		cleft	cleft
		ツイスタ	twister
		faceles	faceless
		せ	視線
		ladc	ladc
		スリー	slley
		口子宮	子宮口
		乳首ヒムアス	乳首ヒムアス
		余る	はみ出る
		パイパン	shaved
		毛が無い	hairless
		お札	bill
		静脈	veins
		のけ	noke
		薄い	薄
		ドラムを叩く	ドラムを叩く
		ドラムの椅子	ドラムの椅子
		マイクスタンド	microphone stand
		胴上げ	tossing someone up in the air
		iPhone	iphone
		着衣	clothing
		cheating	cheating
		痴漢	molester
		地面	ground
		netorare	netorare
		びでお	video
		ビデオ	video
		隠	hidden
		潜める	lurking
		閉じる	close
		ranndoseru 	ranndoseru
		背負う	bear
		くぱ	kupa
		interface	interface
		tip on	tip on
		grra	grra
		grbb	grbb
		吸う	inhale
		leaning	leaning
		spread	spread
		前で	in front
		ガントレット	gauntlet
		写真撮影会	photo session
		overf	overf
		手で目を覆う	covering eyes with hands
		位	rank
		誘惑	temptation
		俯瞰	bird's eye view
		↑	↑
		種	seed
		埋	buried
		しがみ	shigami
		子供の尻	child's butt
		東北	tohoku
		江戸	edo
		和風	和風
		旅籠	旅籠
		旅館	inn
		クジラ	whales
		東洋	東洋
		雲海	sea ​​of ​​clouds
		開く	open
		宣材写真	promotional photo
		anira	anira
		アニラ	anila
		Remilia	remilia
		食い	eat
		ナイチン	nightingale
		present	present
		水につかる	immerse in water
		粘液	mucus
		ぬるぬる	slimy
		感じる	feel
		汁	juice
		鞄を背負う	carry a bag
		大浴場	large communal bath
		日焼け	sunburn
		マフラー	マフラー
		踏	step
		踏む	踏む
		より紙	yorigami
		夕焼け	夕焼け
		daki	daki
		罪	ペニス
		cm	cm
		パーティー	party
		パーティー会場	パーティー会場
		便器	toilet
		便所	便所
		様式便器	様式便器
		洋式便器	western-style toilet
		和式便器	japanese style toilet bowl
		電車の中	on the train
		電車の椅子	train seats
		電車のシート	train seat
		電車の座席	train seats
		バイブ	vibe
		バイブレーター	vibrator
		二人	two people
		duo	duo
		学校の体操着	学校の体操着
		フードを被る	put on the hood
		学校のプール	school swimming pool
		胸まで水に浸かる	water up to one's chest
		右向き	右向き
		スポーク	spok
		エプソン	epson
		髪型	hairstyle
		脚を組む	crossing your legs
		パステル	pastel
		乳首が立っている	nipples are erect
		乳首が勃つ	nipples become erect
		M	m
		チア	チア
		rift	rift
		syn	syn
		seet	seet
		クスコ	cusco
		鏡張りの床	鏡張りの床
		玄関を開ける	open the front door
		ドアを開ける	opening the door
		脚を広げて立つ	脚を広げて立つ
		脚を伸ばす	stretch your legs
		でんぐり返し	somersault
		有馬	arima
		skim	skim
		小顔	小顔
		アクセ	accessories
		wrist scrunchie	wrist scrunchie
		巨根	big cock
		大量	large amount
		neto	neto
		たいい	taii
		だn	it's
		1000	1000
		100	100
		レイヤー	layers
		{nsfw},masterpiece,{{{anime screencap}}},1girl,sagara misae,clannad,apron,blue hair,blue trousers, brown eyes,chignonm,hair up,sleeves rolled up,explicit,yellow apron, white shirt,6 boys,breasts,bukkake, bare shoulders,bra lift,clothing aside,cum,cum in pussy,cum in mouth, cum on body,cum on breasts,cum on clothes,cum on hair,clothed female nude male, dark-skinned male,fellatio,open shirt,vaginal, gangbang,hetero,leg lift,multiple boys,multiple penises,navel,nipples,oral,penis,pussy,rape,sex,skirt lift, spread legs, uncensored, explicit,best quality	{nsfw},masterpiece,{{{anime screencap}}},1girl,sagara misae,clannad,apron,blue hair,blue trousers, brown eyes,chignonm,hair up,sleeves rolled up,explicit,yellow apron, white shirt,6 boys,breasts,bukkake, bare shoulders,bra lift,clothing aside,cum,cum in pussy,cum in mouth, cum on body,cum on breasts,cum on clothes,cum on hair,clothed female nude male, dark-skinned male,fellatio,open shirt,vaginal, gangbang,hetero,leg lift,multiple boys,multiple penises,navel,nipples,oral,penis,pussy,rape,sex,skirt lift, spread legs, uncensored, explicit,best quality
		cun in headwear	cun in headwear
		cum in headwear	cum in headwear
		冴えない	dull
		加藤	kato
		プリコ園	purikoen
		踏みつけ	trampling
		片膝を上げる	片膝を上げる
		grabbing another's	grabbing another's
		首絞め	strangulation
		甲冑	甲冑
		そばかす	そばかす
		頭身	head to body
		余裕	つま先
		決めたい	苦笑い
		整列する	整列する
		cyclops	cyclops
		立ちバック	standing doggy style
		from back	from back
		fixedly	fixedly
		酔	drunk
		あおり	aori
		ハイグレ	high grade
		仰け反る	lean back
		画面に	on the screen
		睨む	睨む
		にら	leek
		陥没	collapse
		penis awe	penis awe
		リード	lead
		oibttauk	oibttauk
		もみあげ	sideburns
		もみ上げ	sideburns
		死姦	death rape
		出産	childbirth
		花かんむり	flower crown
		言葉	words
		ピストン	piston
		反らす	warp
		マシンバイブ	machine vibrator
		タキシード	tuxedo
		bu	bu
		うしろ髪	back of the hair
		腹巻き	stomach band
		大股	大股
		脱ぐ	take off
		素手	素手
		棒オナニー	棒オナニー
		喉	喉
		電マ	電マ
		苦	bitterness
		苦しい	painful
		我慢	patience
		penids	penids
		立ち上がる	stand up
		立つ	stand
		肘をつく	bend your elbows
		ビニール	vinyl
		差し出す	差し出す
		伸ばした	outstreched
		悪党	悪党
		勝利	勝利
		basquet	basquet
		歩行	walking
		睨みつける	glare
		アイマス	idolmaster
		着替え	change of clothes
		スティ	suti
		呆れる	disappointed
		引きつく	attract
		引きついた	attracted
		ドンびく	shock
		ドン引く	shocked
		嫌悪	disgust
		怒る	get angry
		nipple	nipple
		厚地	thick
		おんぶ	おんぶ
		胸もむ	胸をもむ
		手合わせ	手合わせ
		乳首舐め	nipple licking
		漢が	han
		男が	a man
		他人が乳首をなめる	someone else licks my nipples
		全体	whole
		飛行機雲	contrail
		仰望	仰望
		アオリ	aori
		ちんこをにぎる	ちんこをにぎる
		にぎる	にぎる
		見せ槍	見せ槍
		精液	精液
		揺れる胸	shaking breasts
		セクシーな谷間	sexy cleavage
		恥かしい	embarrassing
		生き	living
		オランダ語	dutch
		ニプ	nip
		しがみつく	cling
		吹き飛ぶ	blown away
		飛ばされる	to be blown away
		顔に精液	顔に精液
		焼印	branding
		見ている	loking
		見	look
		こちら	here
		むく	むく
		narmaya	narmaya
		コントラスト	contrast
		腕を伸ばす	stretch your arms
		焼かれた	burned
		空気	air
		かがむ	bend
		コックリング	cock ring
		らくがき	scribble
		腰を突き出す	push out your hips
		朝凪	朝凪
		艦これ	kantai collection
		腰ふり	hip shaking
		dexirudo	dexirudo
		隠れる	隠れる
		尿	urine
		焦る	panic
		縛る	tie up
		退廃的	decadent
		伸びる	extend
		足を伸ばす	stretch your legs
		お風呂に漬かる	soak in the bath
		お風呂に浸かる	take a bath
		master	master
		master piece	master piece
		頭が上	head up
		頭が上にくる	head comes up
		頭を上に描画	draw head up
		録画	recording
		アナルプラグ	anal plug
		Yシャツ	dress shirt
		暖色	warm color
		拉致	abduction
		逆行	retrograde
		旨を隠す	hide the meaning
		ずらす	shift
		ちちくらべ	compare breasts
		父	father
		景色	scenery
		伝説	伝説
		腕を掴む	grab your arm
		ニーソックス	knee socks
		透け	see-through
		ケモミミ	kemomimi
		下澪る	downhill
		faceveil	faceveil
		フェイスベール	フェイスベール
		アームカバー	arm covers
		コルセット	コルセット
		下品	vulgar
		titi 	titi
		お昼	お昼
		室内光	indoor light
		着替	change of clothes
		ベッドライト	bedside lamp
		roomlight	room light
		中くらいの胸	medium chest
		アフター	after
		静止している	静止
		レズ	lesbian
		泣き顔	crying face
		へそピアス	belly button piercing
		顔写	face photo
		pile	pile
		手を頭の後ろ	hands behind head
		真っ赤な太陽	red sun
		elasticized	elasticized
		ソードアート	sword art
		ニップレスを剥がす	peel off the nipple covers
		手を縛る	tying your hands
		半脱ぎ	half-naked
		mating press,	mating press,
		黒塗り	black paint
		黒線	black line
		黒帯	black belt
		ぴちぴち	pichi pichi
		ピチピチ	tight
		オナホ	onahole
		sex toys	sex toys
		クリトリス　ピアス	clitoris piercing
		チンカス	dick cheese
		ちんかす	chinkasu
		結束	unity
		1 girl	1 girl
		フロントホック	front hook
		等身	life size
		textile	textile
		女の子座り	girl sitting
		座	seat
		peeks	peeks
		二重	double
		うさみみ	bunny ears
		見えない	見えない
		まんぐり	piledriver
		愛駅	love station
		星座	constellation
		お尻を掴む	grab your ass
		お尻の穴	anal hole
		ホールドする	ホールド
		膝を立てる	膝を立てる
		フィギュア	figures
		汗が滴る	sweat dripping
		乳輪	乳輪
		染み	染み
		脚を開く	spread your legs
		水辺	waterfront
		スモッ	smocks
		暴力	violence
		暴	violence
		show off nipples	show off your nipples
		赤ちゃん	赤ちゃん
		lyning	lyning
		洋室	western-style room
		洋	western
		下火	fading
		アナルパール	anal pearls
		手形	bill
		赤いお尻	red butt
		腫れる	swelling
		アナルビーズ	anal beads
		anal beas	anal beas
		through wall	through wall
		全裸	completely naked
		pur	pur
		つまむ	pinch
		チラシを拾う	pick up a flyer
		見ない	don't watch
		褌	褌
		半被	half-covered
		傾ける	tilt
		傾	tilt
		トップレス	トップレス
		バース	bath
		フェラチオ	blowjob
		スリット	slit
		suji	suji
		ローライズ	low rise
		絞首台	gallows
		捲	winding
		脱がす	take off
		海老反り	shrimp-like curve
		反る	warp
		透明男	透明男
		夕焼	夕焼
		負け犬	負け犬
		負け犬のポーズ	loser pose
		魔女裁判	witch trials
		衣類	clothing
		地下室	地下室
		石の床	stone floor
		ガムテープ	packing tape
		紐が解ける	the string comes undone
		前掛	apron
		ニップレスを剝がす	peel off nipple covers
		脇を閉める	close your arms
		乳揺れ	breast shaking
		顔をそらす	turn your face away
		カウボーイブーツ	cowboy boots
		あえぎ	gasping
		盗撮	voyeur
		不安	anxiety
		職種	job type
		アナル挿入	anal insertion
		頭頂部	top of the head
		あそこを広げる	spread that place
		挟む	sandwich
		belly button	belly button
		後ろ手に	behind your back
		ジュニア	junior
		破く	破く
		霧氷樹	霧氷樹
		口を塞がれる	mouth covered
		がまん	patience
		イマラチオ	deepthroat
		目線	line of sight
		大の字	spread your legs wide
		be almost there,	be almost there,
		towel blanket	blanket
		もじ	letters
		poop	poop
		紙幣	bill
		胸元	胸元
		wav	wav
		おちょぼ	ochobo
		nsg	nsg
		詳細	detail
		目を向ける	顔を近づける
		 舌	 tongue
		処女膜	hymen
		脚を閉じる	close your legs
		t乳	t breasts
		オトコの娘	オトコの娘
		雑巾がけ	mopping
		床を拭く	mopping the floor
		雑巾	dust cloth
		をaaずらす	shift by aa
		aaをずらす	shift aa
		透ける	透ける
		shirt pull	shirt pull
		チラシ	flyer
		lify	lify
		指をしゃぶる	sucking fingers
		悔しい	regrettable
		悔	regret
		身長	height
		eye	eye
		篝	kagari
		mikl	mikl
		体格	physical build
		㊦	20
		穴開き下着	underwear with holes
		穴開き	穴開き
		ガウン	ガウン
		伏せる	face down
		xray	xray
		結婚指輪	wedding rings
		破瓜	breaking the hymen
		権限	卵子
		absu	absu
		祈る	pray
		めくる	turn over
		丸出し	fully exposed
		バニー	bunny
		ha-to 	ha-to
		開	open
		クリスティーナ	christina
		グラ	gra
		微調整	tweak
		鼻水	snot
		処	processing
		stand	stand
		スクエア	sqa
		msonary	msonary
		misona	misona
		上	上
		抱き枕	body pillow
		数字	numbers
		一面	one side
		腰	waist
		みえる	see
		震	earthquake
		裸」	naked"
		惚気る	play up
		惚	in love
		箒	broom
		ガーリー	girly
		ブラチラ	brasilia
		アメコミ	アメコミ
		ダンスホール	dance hall
		on wall	on wall
		普段着	casual wear
		obliques	obliques
		clotc	clotc
		shop	shop
		単色	monochromatic
		kuti 	kuti
		dishv	dishv
		yoga	yoga
		驚き	surprise
		顔のない	faceless
		froll	froll
		drol	drol
		両性	both sexes
		脂肪	fat
		振る	振る
		doutch	doutch
		コンクリート	concrete
		heels	heels
		双子	twins
		シャツの裾	shirt hem
		画面外	画面外
		腕を組	arms crossed
		ビューワ	viewer
		Semen	semen
		不満	dissatisfaction
		地に	on the ground
		下着姿	in underwear
		buruma aside	buruma aside
		手を組む	join hands
		手を組	join hands
		ローファー	loafers
		抱える	hold
		pantiy	panty
		見切	見切
		頸部	cervix
		から	from
		拭く	wipe
		煙草をくわえる	hold a cigarette in your mouth
		木目	grain
		eエプロmm	e apron mm
		指す	point
		bounc	bounc
		ヘアバンド	hairbands
		敗れた	defeated
		invite	invite
		あびる	abiru
		毛量	hair volume
		ゆるふわ	soft and fluffy
		brab	brab
		にらむ	glare
		キスマーク	kiss mark
		ワンピース	ワンピース
		握手	handshake
		squw	squ
		和室	japanese-style room
		clotvh	cloth
		clotch	clotch
		キャミ	cami
		croth	croth
		饕餮尤魔	eating demon
		犬歯	canine
		♡	♡
		Nightcore Mix	nightcore mix
		路地	alley
		sound	sound
		髪　複雑	hair: complicated
		髪 複雑	hair complex
		鞄を前に抱える	hold your bag in front of you
		teeth.	teeth.
		塗り	paint
		アイマスク	eye mask
		tilt head	tilt head
		deepthroat	deepthroat
		曲がる	bend
		しなる	bending
		細め	thin
		SHARP	sharp
		公式	official
		タッチ	touch
		nsfw,{{{{toon}}}},{{{{thick coating}}}},1girl,{{{{child}}}},{{{{flat chest}}}},{{{{{upper body}}}}},low angle,{{slim legs}},{{{{perfect anatomy}}}},{masterpiece},{best quality},{official style},{depth of field},{highly detailed},{ultra-detailed},{super illustration},{very aesthetic},{intricate},{textile shading},{{overall detail}},{Amazing},{{{{{{nursing handjob}}}}}},{motion lines},full-face blush,looking away,{{{{1viewer's penis}}}},pov,{{large penis}},{{{{veiny penis}}}},{{{{cum overflow}}}},{{{{{{excessive cum}}}}}},{{uncensored}}	nsfw,{{{{toon}}}},{{{{thick coating}}}},1girl,{{{{child}}}},{{{{flat chest}}}},{{{{{upper body}}}}},low angle,{{slim legs}},{{{{perfect anatomy}}}},{masterpiece},{best quality},{official style},{depth of field},{highly detailed},{ultra-detailed},{super illustration},{very aesthetic},{intricate},{textile shading},{{overall detail}},{amazing},{{{{{{{nursing handjob}}}}}}},{motion lines},full-face blush,looking away,{{{{1viewer's penis}}}},pov,{{large penis}},{{{{veiny penis}}}},{{{{cum overflow}}}},{{{{{{excessive cum}}}}}},{{uncensored}}
		shy	shy
		isshiki	isshiki
		遊ぶ	play
		jeart	jeart
		中指	中指
		完璧	perfection
		コピック	copic
		首を傾げる	tilt one's head
		公衆	public
		ぷに	puni
		プニ	puni
		卵	egg
		ペタン	petan
		美白	whitening
		潰れた	collapsed
		繋	connection
		areola	areola
		照れ笑い	shy laugh
		涙目	teary-eyed
		嫌がる	嫌がる
		抵抗	resistance
		負け	喪失
		手描き	hand-drawn
		さらさら	さらさら
		喫茶店	coffee shop
		cup	cup
		シニョン	chignon
		tixyai	tixyai
		チャイナ	china
		燕尾	swallowtail
		exec	exec
		あへ	あへ
		協会	association
		水玉模様のコットンパンティー、	polka dots cotton panties,
		指さす	point
		向かい合う	向かい合う
		衝撃	impact
		ポケモン	pokémon
		fif	fif
		抑えつけ	suppress
		パンティーショット	panty shot
		腕をつかむ	grab your arm
		服を引っ張る	pulling on clothes
		rei	rei
		dide	dide
		ズラス	zuras
		マイクロ	micro
		傾げる	tilt
		海辺	seaside
		strug	strug
		teethh	teethh
		正常い	normal
		ノーパン	no underwear
		内また	inner thigh
		きょ	emptiness
		洞窟	cave
		サンダル	sandals
		上履き	indoor shoes
		蒸し物	steamin
		われめ	were
		割れ目	crack
		ベロ	vero
		手のひら	palm
		問題	ラブホテル
		nipple tweak	nipple tweak
		階段を上る	climbing the stairs
		glou	glou
		大学	university
		strugg	strugg
		眠って	asleep
		店の前	in front of the store
		服を脱ぐ	take off your clothes
		パイプ	パイプ
		sheets	sheets
		配信	delivery
		brests	brests
		brest	brest
		empty_eyes 	empty_eyes
		つり革	straps
		umc	umc
		名札	name tag
		セット	集合
		露天風呂	open-air bath
		同じ	same
		ランニングシャツ	running shirt
		縁日	fair
		体毛	body hair
		深夜	late night
		インナー	inner
		ダブルペース	double pace
		(泣)	(cry)
		ボディコン	bodycon
		腰を掴む	腰を掴む
		逸らす	divert
		反り返る	bend
		vagia	vagia
		vagnal	vagnal
		友達と話している	talking to friends
		直立不動	直立不動
		口紅	口紅
		髪を結う	髪を結う
		髪を結ぶ	tying up hair
		歯を磨く	brush your teeth
		歯ブラシ	toothbrush
		ラブラブ	love love
		セルフ	self
		股を開く	spread your legs
		closs	closs
		下駄箱	下駄箱
		靴を脱ぐ	take off your shoes
		踵	heel
		道場	dojo
		晒し	exposing
		バキュム	bakyu-mu 
		ファラ	farah
		膨らんだ頬	puffy cheeks
		くばぁ	kubaa
		emm	emm
		服を脱がす	undress
		相手の服を脱がす	remove someone's clothes
		afeter	afeter
		抱きしめる	抱きしめる
		汚れた肌	汚れた肌
		泥汚れ	泥汚れ
		キンタマ	kinntama 
		テカリ	テカリ
		Airy	airy
		噛む	bite
		虚ろ	hollow
		敗北	defeat
		分け目	parting
		粘膜	mucous membrane
		膝を抱える	hold your knees
		前張り	front lining
		膝を曲げる	bend your knees
		チラ見せ	a sneak peek
		胸　チラ見せ	chest flashing
		reverse	reverse
		引き戸	sliding door
		店員	clerk
		スーパーの袋	supermarket bag
		ビニール袋	plastic bags
		肘をかける	rest your elbows
		あばら	あばら
		痩せ	thin
		痩せた	lost weight
		エジュカット	ejucat
		教育	educ
		eju	eju
		勃起	勃起
		バレエ	バレエ
		乳首吸う	nipple sucking
		敷布団	mattress
		恥ずかしい顔	embarrassed face
		羞恥	shame
		全身絵	full body painting
		保健	保健
		空想	空想
		検閲	censorship
		挑発	taunt
		ブラをはずす	remove your bra
		白血球	白血球
		shiba	shiba
		掃除機	vacuum cleaner
		野球	baseball
		グラビア	gravure
		wedi	wedi
		縦に並ぶ	vertical
		並ぶ	line up
		みつあみ	three-stranded
		片目	one eye
		後	rear
		ローツ	lohtz
		のどちんこ	uvula
		ネガティブ	negative
		傷	scratch
		cleve	cleve
		興奮	興奮
		聴診器	stethoscope
		stradding	stradding
		souken	souken
		うつぶせ	face down
		吊り上がった	吊り上がった
		口角	corner of mouth
		アナルフック	anal hook
		失禁	失禁
		impregna	impregna
		Bridge	bridge
		アへ	ahe
		バランスボール	バランスボール
		気を付け	be careful
		直立	upright
		ovum	ovum
		唾液ローション	saliva lotion
		ローション	lotion
		つば	spit
		致命的	fatal
		クマ	bear
		twoside	twoside
		シャツを出す	シャツを出す
		浸け	immersion
		さかまた	sakamata
		disembo	disembo
		二ー	two
		添い寝	sleeping together
		ベット	bet
		celling	celling
		unbo	unbo
		bury	bury
		rmb	rmb
		半分	half
		体勢	posture
		座る	座る
		見る	look
		口内	in the mouth
		顔面射精	facial ejaculation
		中指を立てる	raise the middle finger
		脱いだ下着	脱いだ下着
		脱いだ	脱いだ
		筋	logic
		絶頂	climax
		イキ	iki
		咥える	hold in mouth
		小さい	小さい
		ようこそ	ようこそ
		tribe	tribe
		部族	tribe
		一枚	一枚
		原始	primitive
		Tribalwear	tribalwear
		いじめ	bullying
		滴る	dripping
		座布団	japanese cushion
		boxer	boxer
		露出する	露出
		公	公
		失神	失神
		ちんぐち	ちんぐち
		本物	real
		悪堕ち	fallen into evil
		悪	evil
		椅子に座る	sit on a chair
		kwaii	kwaii
		戻る	背中
		脱ぎ	undress
		グラウンド	ground
		胸で挟む	hold with chest
		スリングショット	slingshot
		強制	compulsion
		遠近	遠近
		望遠	telephoto
		表情	facial expression
		舐める	lick
		中性的な	中性的
		中性	neutral
		上半身裸	上半身裸
		年差	年の差
		媚薬	aphrodisiac
		きしむ	squee
		アイスを食べる	アイスを食べる
		セイラー服	sailor suit
		ラバー	rubber
		えなめる	enamel
		mesh	mesh
		向	direction
		looking	looking
		X線	x-ray
		テープ	tape
		tap	tap
		テープ	tape
		対面	face-to
		合い	match
		店	店
		離れる	leave
		離れ	annex
		相手	partner
		丸呑み	swallowed whole
		トランプ	trump
		lifted	lifted
		sung	sung
		embr	embr
		duch	duch
		datch	datch
		sibori	sibori
		絞り	aperture
		シボリ	shibori
		歯	teeth
		ラヴ	love
		恋人	lover
		腕	arm
		愛撫	caress
		脚を抱える	hold the legs
		head_back	head_back
		頭を後ろに	head back
		髪の毛かき	hair combing
		狐	狐
		マロまゆ	maro eyebrows
		マロ	maro
		狐尻尾	fox tail
		きんぱつ	kinpat
		ガータベルト	garter belt
		赤目	red eye
		ツインテル	ツインテ―ル
		ミリタリーロリィタ	military lolita
		な規模クロ	large scale
		手綱	reins
		ジョプセイ	jyopsei 
		jyasei 	jyasei
		ミリタリーロリータ	military lolita
		ブルーアーカイブ	ブルーアーカイブ
		buru-a-kaibu 	buru-a-kaibu
		顔アップ	face close-up
		獣	獣
		股の下	under the crotch
		T	t
		Tポーズ	tポーズ
		strudding	strudding
		警察署	police station
		オアシス	oasis
		rmbr	rmbr
		異装	disguise
		qun	qun
		spokun	spokun
		手	手
		爪	fingernails
		酢又	vinegar
		swx	swx
		前掛け	apron
		縞パン	striped pants
		肩出し	shoulder bare
		脱	escape
		node	node
		2リ	2リ
		2人の女の子1人の男の子	2 girls 1 boy
		貧乳	貧乳
		大人の女性	adult women
		チャイナドレス	chinese dress
		チーパオ	qipao
		akusyu 	akusyu
		1本の尻尾	one tail
		激しい	intense
		ズレ	misalignment
		水をかける	pour water on
		並んでいます	並んで
		ぷっぷく	俯く
		しゃぶる	しゃぶる
		吐く	vomit
		冷戦	cold war
		リビング	living
		途	on the way
		つぶ	crush
		素又	sumata
		黒タイツ	black tights
		スリング	sling
		対面剤	counteragent
		肩を組む	put your arm around someone's shoulder
		business card	business card
		こだわり	覗き
		路地裏	路地裏
		ビジネス	business
		おぼん	obon
		どや	how about that?
		impreg	impreg
		両手を重ねて	with hands together
		手を重ねる	put your hands together
		げた箱	shoe box
		bra peek:1.2)	bra peek:1.2)
		証明	proof
		キャンプ	camp
		out tongue	out tongue
		薄目	薄目
		テーマ、 	theme, 
		pinkt hem	pinkt hem
		pinkt them	pinkt them
		辛い	spicy
		セミロングヘア	セミロングヘア
		結婚	結婚
		結婚式、	wedding,
		上げ	raise
		神	神
		cross-section	cross-section
		壁に手をつく	put your hands on the wall
		klonoa	klonoa
		ちんぐりがえし	turning head
		ちんちん	chin
		絵柄	pictorial pattern
		oiran	oilan
		絆創膏を剥がす	remove the bandage
		絆創膏をめくる	絆創膏をめくる
		後ろ	behind
		集中	集中
		come hither, 	come hither,
		ロケット 	rocket
		internal cumshot	internal cumshot
		facing	facing
		雰囲気	atmosphere
		なでる	petting
		エプロン	apron
		押したお	pressed
		効果音	sound effects
		尿道攻め	urethra attack
		ホタル	firefly
		スターレイル	star rail
		負け,	loss,
		alternate costume	alternate costume
		pubic stubble	public stubble
		ホットパンツ	hot pants
		ホット	hot
		Completely naked	completely naked
		score	score
		 catlike eyes	cat-like eyes
		4	4
		 立 	 standing
		壁に	on the wall
		鬼頭	kito
		head_tilt	head_tilt
		handcuffs	handcuffs
		見せつけ	showing off
		乱れた服	disheveled clothes
		お金	お金
		令呪	command spell
		asus	asus
		ヒョウ柄	leopard print
		処女	virgin
		sobbing,crying with eyes open,sad,despair,horrified,	sobbing,crying with eyes open,sad,despair,horrified,
		情熱	passion
		constriction	constriction
		恍惚	ecstasy
		うじょ	胸ｗじょ
		レース場	racetrack
		hyousi 	hyousi
		lock	lock
		シール	seal
		open arms forward	open arms forward
		panty gag, 	panty gag,
		dead drunk	dead drunk
		kabedon	kabedon
		loose bra	loose bra
		crotchless	crotchless
		肌	肌
		ｇ	g
		整備	maintenance
		hand between legs, 	hands between legs,
		嫉妬深い	jealous
		アイドルマスター	the idolmaster
		hair censor	hair censor
		白人	white people
		つねる	pinch
		尿道	urethra
		donation box	donation box
		piピース	pi piece
		悪落ち	falling bad
		arms on	arms on
		足袋	tabi
		ガマン	patience
		頭を下げて	bow your head
		ホクロ	mole
		親子	parent and child
		糞尿	糞尿
		もっこり	erection
		シーッ	shhhh
		静かに	quietly
		{upright straddle	{upright straddle
		押し付ける	impose
		顔を背ける	turn away
		ウルトラ	ultra
		パンサープリント	panther_print
		obscene	obscene
		髪をまとめる	tie your hair up
		Backlit	backlit
		裏路地	back alley
		女体盛り	woman on a plate
		女体	female body
		しー	shi
		おてんば	tomboy
		ボーイッシュ	boyish
		援助	assistance
		ヌルヌル	slimy
		on_side	on_side
		 femdom	femdom
		昆虫	insect
		biting	biting
		Scoop with hands,	scoop with hands,
		plaid 	plaid
		巨大な乳輪	huge areolae
		areolae	areolae
		erectile	erectile
		胸を出した	breast out
		ramanda	ramanda
		pirce	pirce
		スモッ具	smocks
		スモッグ	スモッグ
		incredibly absurdres	incredibly absurd
		contrapposto	contrapposto
		straggle	straggle
		struggle	struggle
		繋ぎ	connection
		繋ぐ	connect
		小便	piss
		用を足す	relieve yourself
		聖水	holy water
		stragg	stragg
		bondage outfit	bondage outfit
		visible air	visible air
		口に	in the mouth
		around	around
		サムズ	sams
		sir	sir
		dil	dil
		parp	parp
		Drool	drool
		pantieline	panty line
		 hand on mouth	hand on mouth
		contraction	contraction
		収縮	contraction
		kitt	kitt
		ed	ed
		なめ	lick
		タバコを吸える	タバコを咥える
		facing to the side	facing the side
		射影	projection
		adult	adult
		大人大人	大人大人
		大人	adult
		横向け寝	side sleeping
		横向け　身体	sideways body
		横方向	横向け
		横向き枕	横向け枕
		頭を上げる	lift your head
		曲げる	bend
		ビーチチェアー	beach chairs
		弾む	bounce
		pubic stubble,testicle,	public stubble, testicle,
		bowlegged pose	bowlegged pose
		履歴書	cv
		arms_at_sides,	arms_at_sides,
		お茶	お茶
		peeking out	peeking out
		髪をいじる	playing with hair
		ピースサイン	ピースサイン
		clear liquid 	clear liquid
		支	support
		横目	横目
		涙袋	tear bags
		くま	bear
		オホ	oho
		sexy	sexy
		eyeblow	eyeblow
		drool	drool
		太い	thick
		包茎	phimosis
		仮生包茎	phimosis
		仮性包茎	phimosis
		包皮	包皮
		くすぐる	くすぐる
		陰嚢	陰嚢
		発射	firing
		髪がかかる	hair loss
		撫で	petting
		撫でる	petting
		ナデナデ	ナデナデ
		巻きつく	wrap around
		輝きのない	輝きのない
		腕をつく	put your arms up
		うずくまる	crouch down
		背中を曲げる	bend your back
		涙の筋	tear streaks
		顔が近い	顔が近い
		うつむく	look down
		下を向く	look down
		向き合える	顔を俯かせる
		絶絶	気絶
		脱力	weakness
		勢いある	堪える
		我慢の表情	我慢の表情
		耐える	我慢する
		意識が遠のく	loss of consciousness
		意識が飛ぶ	loss of consciousness
		力が抜ける	relax
		意識を失う	loss of consciousness
		アイライン	eyeliner
		背骨	spine
		背筋	back muscles
		うなじ	nape
		振りむく	turn around
		手を	hands
		condom	condominium
		呼吸	breathing
		荒い	rough
		種付け	seeding
		making	making
		種付	seeding
		faceplant,	faceplant,
		体をひねる	twist your body
		アマゾネス	amazoness
		だいしゅき	i love you
		反り	warp
		mons pubis	mons public
		doujin cover	doujin cover
		垂れる	drooping
		腕を組む	cross your arms
		prown	prown
		かにばさみ	crab claws
		上位	top
		niblling	nibbling
		plasticien	plasticine
		同一	same
		ハイネック	ハイネック
		scowl	scowl
		鳥山	toriyama
		upskirt,	upskirt,
		edj	edj
		ぜっちょ	zecho
		exessive	exessive
		exe	exe
		attack	attack
		絶頂y	climax y
		copyright	copyright
		オイル	オイル
		crit	crit
		充血	hyperemia
		キンタマ	balls
		皿	dish
		一重	single layer
		呆れ	dismayed
		猫背	猫背
		子犬	pupp
		バスタオル	bath towels
		curtsey	curtsey
		慎重	careful
		clothed female	clothed female
		ボタン	botton
		head tilt,	head tilt,
		edju	edju
		figure four sitting,	figure four sitting,
		claw foot bathtub	claw foot bathtub
		乳首を吸う	sucking nipples
		のけぞる	lean back
		st	st
		shoe_soles	shoe_soles
		fromt	fromt
		乳首の線	nipple line
		lean back	lean back
		sider	sider
		唇	lips
		近	near
		距離	distance
		サンドイッチ	sandwich
		sand	sand
		,button gap	,button gap
		UC	u.c.
		ノイズ	noise
		cross arm	cross arm
		腕を広げて、	spreading arms, 
		spreading arms	spreading arms
		bung	bung
		Through	through
		against glass	against glass
		剃り	shaving
		full-harness made of rope	full-harness made of rope
		pile-driver	pile driver
		fitting room	fitting room
		顎マスク	顎マスク
		手を交差	hands crossed
		覆われた貫通	covered penetration
		holding_another's_wrist	holding_another's_wrist
		剃り返る	shave head
		のけ反る	lean back
		Support	support
		stimulation	stimulation
		パンツをはいてない	no pants on
		見切れ	見切れ
		舌なめずり	licking one's lips
		smelling	smelling
		ぱふ	ぱふ
		pillarboxed	pillarboxed
		foreskin	foreskin
		foreskin penis	foreskin penis
		狭い	狭い
		痛い	痛い
		つまむ	pinching
		テーブルクロス	tablecloths
		口飲食	口を開ける
		倒れる	fall down
		構造	structure
		ノケ	noke
		後ろに寄りかかる	lean back
		exhaustion	exhaustion
		そり	sled
		サテン	satin
		manicure	manicure
		セクシーポーズ	sexy pose
		織姫	織姫
		洗脳	brainwashing
		broad shoulders	broad shoulders
		手を降る	手を降る
		差し迫った侵入	imminent penetration
		東北イタコ	tohoku itako
		ほっぺ	cheeks
		Zettai ryouiki	the most important thing
		 imminent penetration,	imminent penetration,
		水性	aqueous
		胸を張る	be proud
		毛布	blanket
		cut-in	cut-in
		lavia	lavia
		fleck	fleck
		freck	freck
		breasts shade	breast shade
		minimal background	minimal background
		;>	;>
		Vibe	vibe
		挿入	insert
		piping	piping
		uppri	uppri
		膨れ	swelling
		confrontation	confrontation
		 roll uped	rolled up
		partially underwater	partially underwater
		もたれる	lean
		もたれ	lean
		あお向け	lying on your back
		ツーショット	two shots
		saliva_trail	saliva_trail
		deep_penetration	deep_penetration
		piasu	piasu
		squatting_cowgirl_position	squatting_cowgirl_position
		直前	last minute
		あいまい	ambiguous
		曖昧	ambiguous
		Upside-Down	upside-down
		年齢	年齢
		剃	shaved
		Shaved	shaved
		Sha	sha
		Shave	shave
		cum on mouth,cream pie,	cum on mouth,cream pie,
		crop_top_overhang	crop_top_overhang
		離れた	departed
		渡す	hand over
		こっそり	こっそり
		shaft look	shaft look
		klee (genshin impact) ,blond hair, low twintail, red eyes, cabbie hat, white shorts, long sleeves, pointy ears, red dress, backpack, red headwear, brown gloves	klee (genshin impact) ,blond hair, low twintail, red eyes, cabbie hat, white shorts, long sleeves, pointy ears, red dress, backpack, red headwear, brown gloves
		畳む	fold
		弛緩	flaccid
		着用	wearing
		wearing clothes	wearing clothes